00 00 00 00 00 00 00 00 00 00 00 00 00
00 05 31 16 17 16 31 31 31 31 31 31 00 
00 00 00 00 00 00 00 00 00 00 00 31 00
00 09 31 31 02 31 00 11 07 31 00 31 00
00 31 18 31 00 31 00 12 09 31 00 31 00
00 00 02 00 00 31 00 00 00 02 00 31 00
00 07 31 31 00 31 02 20 22 20 00 31 00
00 31 19 31 00 31 00 00 00 00 00 31 00
00 00 02 00 00 31 31 31 31 31 31 31 00
00 31 31 31 00 00 02 00 00 00 02 00 00
00 09 31 07 00 07 31 31 00 00 20 00 00
00 09 13 07 00 31 24 31 00 16 10 16 00
00 00 00 00 00 00 00 00 00 00 00 00 00