00 00 00 00 00 00 00 00 00 00 00 00 00 
00 06 31 03 31 31 31 31 31 31 31 31 00 
00 31 31 00 00 31 30 31 30 31 00 00 00 
00 31 00 00 00 00 00 31 00 00 00 00 00 
00 31 00 07 07 00 31 31 31 00 31 28 00 
00 31 00 07 31 29 31 31 31 29 31 31 00 
00 31 00 00 00 00 31 31 31 00 00 00 00 
00 31 00 27 31 00 31 31 31 00 31 25 00 
00 31 00 31 31 29 31 31 31 29 31 31 00 
00 31 00 00 00 00 31 31 31 00 00 00 00 
00 31 00 10 10 00 31 31 31 00 31 31 00 
00 05 00 10 31 29 31 31 31 29 31 31 00 
00 00 00 00 00 00 00 00 00 00 00 00 00 