00 00 00 00 00 00 00 00 00 00 00 00 00 
00 07 12 00 07 10 07 00 31 00 31 09 00 
00 31 07 00 10 07 10 00 31 02 20 31 00 
00 22 31 00 07 08 07 00 31 00 00 00 00 
00 02 00 00 00 31 00 00 31 00 31 33 00 
00 31 31 20 31 31 31 31 31 31 31 31 00 
00 02 00 00 31 31 31 00 31 00 00 00 00 
00 18 31 00 00 31 00 00 31 00 31 09 00 
00 31 07 00 31 31 31 00 31 02 22 07 00 
00 09 11 00 31 31 31 00 31 00 00 00 00 
00 00 00 00 00 31 00 00 16 00 31 31 00 
00 06 31 31 31 31 31 00 31 02 31 05 00 
00 00 00 00 00 00 00 00 00 00 00 00 00 