00 00 00 00 00 00 00 00 00 00 00 00 00 
00 31 08 31 00 31 26 31 00 31 33 31 00 
00 09 31 07 00 31 31 31 00 07 31 10 00 
00 31 22 31 00 31 31 31 00 31 19 31 00 
00 00 02 00 00 00 03 00 00 00 02 00 00 
00 31 31 31 02 31 17 31 31 18 31 31 00 
00 31 31 31 00 00 00 00 00 00 00 00 00 
00 17 31 16 31 31 31 31 31 31 31 31 00 
00 02 00 00 02 00 00 00 02 00 00 02 00 
00 31 00 31 20 31 00 31 22 31 00 31 00 
00 31 00 16 31 07 00 11 31 09 00 31 00 
00 05 00 07 16 07 00 31 16 31 00 06 00 
00 00 00 00 00 00 00 00 00 00 00 00 00 