00 00 00 00 00 00 00 00 00 00 00 00 00 
00 31 00 31 17 02 31 00 31 31 02 31 00 
00 31 00 31 31 00 07 00 16 16 00 17 00 
00 31 02 20 31 00 31 00 07 07 00 31 00 
00 00 00 00 02 00 20 00 07 07 00 31 00 
00 07 31 22 31 00 31 00 00 00 00 31 00 
00 07 31 31 20 00 31 16 31 31 31 31 00 
00 00 19 00 00 00 31 00 00 00 00 17 00 
00 31 31 31 31 00 16 00 31 31 31 31 00 
00 11 07 09 14 00 31 00 02 00 00 00 00 
00 00 00 00 00 00 31 00 31 00 31 31 00 
00 06 31 31 31 31 31 00 31 01 31 34 00 
00 00 00 00 00 00 00 00 00 00 00 00 99